NO ./textures/rome2.png
SO ./textures/rome1.png
WE ./textures/rome4.png
EA ./textures/rome3.png

F 0,173,173
C 0,0,0

        1111111111111111111111111
        1000000000110000000000001
        1011000001110000000000001
        1001000000000000000000001
111111111011000001110000000000001
10000000001100000111P1P111P111111
11110111111111011100000010001
111101111111110111P1111010001
110000001101010111000000P0001
10000000000000001100000010001
10000000000000001101010010N01
11000001110101011111011110001
11110111 1110101 101111010001
11111111 1111111 111111111111
