NO ./textures/rome2.png
SO ./textures/rome1.png
WE ./textures/rome4.png
EA ./textures/rome3.png

F 0,173,173
C 0,0,0

        1111111111111111111111111
        1000000000110000000000001
        1011000001110000000000001
        1001000000000000000000001
111111111011000001110000000000001
100000000011000001110111111111111
11110111111111011100000010001
11110111111111011101011010001
11000000110101011100000010001
10000000000000001100000010001
10000000000000001101010000N01
11000001110101011111011110001
11110111 1110101 101111010001
11111111 1111111 111111111111
