NO ./textures/sssssq.png
SO ./textures/sssssq.png
WE ./textures/sssssq.png
EA ./textures/sssssq.png

F 100,173,173
C 100,100,100

        1111111111111111111111111
        1000000000110000000000001
        1011000001110000000000001
        1001000000000000000000001
111111111011000001110000000000001
10000000001100000111P1P111P111111
11110111111111011100000010001
111101111111110111111111P1111
11000000110101011110000000011
10000000000000001110000000011
100000000000000011P000N0000P1
11000001110101011110000000011
11110111 1110101 1111111P1111
11111111 1111111 111111111111
