NO ./Mandatory/textures/rome1.png
SO ./Mandatory/textures/rome2.png
WE ./Mandatory/textures/rome3.png
EA ./Mandatory/textures/rome4.png

F 100,100,100
C 100,173,173

        1111111111111111111111111
        1000000000110000000000001
        1011000001110000000000001
        1001000000000000000000001
111111111011000001110000000000001
100000000011000001110101110111111
11110111111111011100000010001
11110111111111011111111101111
11000000110101011110000000011
10000000000000001110010000011
1000000000000000110010N000001
11000001110101011110000000011
11110111 1110101 111111101111
11111111 1111111 111111111111
