NO ./Mandatory/textures/rome2.png
SO ./Mandatory/textures/rome1.png
WE ./Mandatory/textures/rome4.png
EA ./Mandatory/textures/rome3.png

F 0,173,173
C 0,0,0

     111
    10W01
111111111111
