NO ./Bonus/textures/rome2.png
SO ./Bonus/textures/rome1.png
WE ./Bonus/textures/rome4.png
EA ./Bonus/textures/rome3.png

F 0,173,173
C 0,0,0

11111111
10000001
1E00P001
10000001
11111111
