NO ./Bonus/textures/rome1.png
SO ./Bonus/textures/rome2.png
WE ./Bonus/textures/rome3.png
EA ./Bonus/textures/rome4.png

F 100,173,173
C 100,100,100

        1111111111111111111111111
        1000000001P10000000000001
        1011000001010000000000001
        1001000000000000000000001
111111111011000001110000000000001
1000000000110000011101P1110111111
1111P111111111011100000010001
111101111111110111111P1101111
110000001101P1011110000000011
10000000000000001110000000111
100000000000000011000N0000011
11000001110101011110011100011
11110111 1110101 111111101111
11111111 1111111 111111111111
