NO ./Bonus/textures/rome1.png
SO ./Bonus/textures/rome2.png
WE ./Bonus/textures/rome3.png
EA ./Bonus/textures/rome4.png

F 100,173,173
C 100,100,100

        1111111111111111111111111
        1000000000110000000000001
        1011000001110000000000001
        1001000000000000000000001
111111111011000001110000000000001
100000000011000001110101110111111
11110111111111011100000010001
11110111111111011111111101111
11000000110101011110000000011
10000000000000001110010000111
100000000000000011001N1000011
11000001110101011110011100011
11110111 1110101 111111101111
11111111 1111111 111111111111
