NO ./Bonus/textures/rome2.png
SO ./Bonus/textures/rome1.png
WE ./Bonus/textures/rome4.png
EA ./Bonus/textures/rome3.png

F 0,173,173
C 0,0,0

1111111
1000001
1111101
    101
    10111111
    100W0001
    11111111
